62,62,62,62,62,62,62,62,62,62,62,62,62,62,62,62,62,62,62,62,62,62,62,62,62,62,62,62,62,62,62,62,62,62,62,62,62,62,62,62,62,62,62,62,62,62,62,62,62,62,
62,62,77,62,62,62,62,62,62,77,62,62,62,62,62,62,62,62,62,62,62,62,62,62,62,62,62,62,62,62,62,62,62,62,62,62,62,62,62,62,62,62,62,62,62,62,62,62,62,62,
62,77,62,62,62,62,62,62,62,62,62,62,62,24,25,62,62,62,62,77,62,62,62,77,62,62,62,62,62,62,62,62,62,62,62,62,62,62,62,62,62,62,62,62,62,62,62,62,62,62,
78,62,62,62,62,62,77,62,62,24,25,27,15,40,41,14,62,62,62,62,62,62,62,62,62,62,62,62,62,62,62,62,62,62,62,62,62,62,62,62,62,62,62,62,62,62,62,62,62,62,
62,62,62,62,62,24,25,27,15,40,41,43,0,0,0,0,14,62,62,62,62,62,62,62,62,62,62,62,77,62,62,62,62,62,62,62,62,62,62,62,62,62,62,62,62,62,62,62,62,62,
78,62,62,15,42,40,41,42,0,0,0,0,0,0,0,0,0,14,24,25,21,21,62,62,62,62,62,77,62,62,62,62,62,62,62,62,62,62,62,62,62,62,62,62,62,62,62,62,62,62,
62,63,15,0,0,0,0,0,0,0,0,0,0,0,0,0,0,0,40,41,37,37,44,62,77,62,62,62,62,62,62,62,62,62,62,62,62,62,62,62,62,62,62,62,62,62,62,62,62,62,
78,79,0,0,0,0,0,0,0,0,0,0,0,0,0,0,0,0,0,0,0,59,60,62,77,62,62,62,62,77,62,62,62,62,62,62,62,62,62,62,62,62,62,62,62,62,62,62,62,62,
3,4,6,6,7,0,0,0,0,0,0,0,0,0,0,0,0,0,0,0,0,0,76,62,62,62,62,62,77,62,62,62,62,62,62,62,62,62,62,62,62,62,62,62,62,62,62,62,62,62,
78,79,0,0,0,0,0,0,0,0,0,0,0,0,0,0,0,0,0,0,0,0,14,62,62,62,62,62,62,62,62,62,62,62,62,62,62,62,62,62,62,62,62,62,62,62,62,62,62,62,
62,63,64,0,0,0,0,0,0,0,0,0,0,0,0,0,0,0,0,0,0,0,0,92,93,94,93,94,25,62,62,62,62,62,21,21,62,62,21,62,62,62,62,62,62,62,62,62,62,62,
78,79,0,0,0,0,0,0,0,0,0,0,0,0,0,0,0,0,0,0,0,0,0,108,109,110,109,110,14,93,94,93,94,15,37,37,0,0,37,17,18,62,62,62,62,62,62,62,62,62,
62,63,0,0,0,0,0,0,0,0,0,0,0,74,75,0,0,0,0,0,0,0,0,0,0,0,0,0,0,0,108,109,110,0,0,0,0,0,0,33,34,62,62,62,62,62,62,62,62,62,
78,79,0,0,0,0,0,0,0,74,75,0,0,90,91,0,0,0,0,0,0,0,0,0,0,0,0,0,0,0,0,0,0,0,0,0,0,0,0,0,62,62,62,62,62,62,62,62,62,62,
62,63,0,0,74,75,0,0,0,90,91,0,0,106,107,0,0,0,0,0,0,0,0,0,0,0,0,0,0,0,0,0,0,0,0,0,0,0,0,17,18,62,62,62,62,62,62,62,62,62,
78,79,0,0,90,91,0,0,0,106,107,0,0,106,107,0,0,0,0,0,0,0,0,0,0,0,0,0,0,0,30,49,50,29,30,51,28,52,30,33,34,62,62,62,62,62,62,62,62,62,
25,15,0,0,106,107,0,0,0,106,107,0,0,106,107,0,0,0,0,0,0,0,0,0,0,0,0,0,81,82,46,65,66,45,46,67,46,68,46,46,62,62,62,62,62,62,62,62,62,62,
41,0,0,0,106,107,0,0,0,106,107,0,0,106,107,0,0,0,0,0,0,0,0,0,0,0,0,59,60,62,62,77,62,77,77,77,62,62,62,62,62,62,62,62,62,62,62,62,62,62,
0,0,0,0,106,107,0,0,0,106,107,0,0,78,63,0,0,0,0,0,0,0,0,0,0,0,0,0,76,62,62,62,62,62,62,62,62,62,62,62,62,62,62,62,62,62,62,62,62,62,
0,0,0,0,106,107,0,81,82,78,78,49,50,78,79,0,0,0,0,0,0,0,0,0,0,0,0,59,60,62,62,62,62,62,62,62,62,62,62,62,62,62,62,62,62,62,62,62,62,62,
29,30,49,50,106,107,22,97,98,78,78,65,66,78,63,0,0,0,0,0,0,0,0,0,0,0,0,0,76,62,62,62,62,62,62,62,62,62,62,62,62,62,62,62,62,62,62,62,62,62,
45,46,65,66,78,78,38,78,78,78,78,61,61,78,63,0,0,0,0,0,0,0,0,0,49,50,81,44,62,62,62,62,62,62,62,62,62,62,62,62,62,62,62,62,62,62,62,62,62,62,
61,61,61,61,61,61,54,61,61,61,77,61,61,78,79,16,16,16,16,16,16,16,16,16,65,66,62,62,62,62,62,77,62,62,62,62,62,62,62,62,62,62,62,62,62,62,62,62,62,62,
61,77,77,61,61,61,61,61,61,77,61,61,61,78,62,32,32,32,32,32,32,32,32,32,62,62,62,62,62,62,77,62,62,62,62,62,62,62,62,62,62,62,62,62,62,62,62,62,62,62,
61,77,61,61,61,61,61,61,61,61,61,61,61,78,62,32,32,32,32,32,32,32,32,32,62,62,62,62,62,62,62,62,62,62,62,62,62,62,62,62,62,62,62,62,62,62,62,62,62,62,
0,0,0,0,0,0,0,0,0,0,0,0,0,0,0,0,0,0,0,0,0,0,0,0,62,62,62,62,77,62,62,62,62,62,62,62,62,62,62,62,62,62,62,62,62,62,62,62,62,62,
0,0,0,0,0,0,0,0,0,0,0,0,0,0,0,0,0,0,0,0,0,0,0,0,0,62,62,77,62,62,62,62,62,0,0,0,0,0,0,0,0,0,0,0,0,0,0,0,0,0,
0,0,0,0,0,0,0,0,0,0,0,0,0,0,0,0,0,0,0,0,0,0,0,0,0,0,0,0,0,0,0,0,0,0,0,0,0,0,0,0,0,0,0,0,0,0,0,0,0,0,
0,0,0,0,0,0,0,0,0,0,0,0,0,0,0,0,0,0,0,0,0,0,0,0,0,0,0,0,0,0,0,0,0,0,0,0,0,0,0,0,0,0,0,0,0,0,0,0,0,0,
0,0,0,0,0,0,0,0,0,0,0,0,0,0,0,0,0,0,0,0,0,0,0,0,0,0,0,0,0,0,0,0,0,0,0,0,0,0,0,0,0,0,0,0,0,0,0,0,0,0,
0,0,0,0,0,0,0,0,0,0,0,0,0,0,0,0,0,0,0,0,0,0,0,0,0,0,0,0,0,0,0,0,0,0,0,0,0,0,0,0,0,0,0,0,0,0,0,0,0,0,
0,0,0,0,0,0,0,0,0,0,0,0,0,0,0,0,0,0,0,0,0,0,0,0,0,0,0,0,0,0,0,0,0,0,0,0,0,0,0,0,0,0,0,0,0,0,0,0,0,0,
0,0,0,0,0,0,0,0,0,0,0,0,0,0,0,0,0,0,0,0,0,0,0,0,0,0,0,0,0,0,0,0,0,0,0,0,0,0,0,0,0,0,0,0,0,0,0,0,0,0,
0,0,0,0,0,0,0,0,0,0,0,0,0,0,0,0,0,0,0,0,0,0,0,0,0,0,0,0,0,0,0,0,0,0,0,0,0,0,0,0,0,0,0,0,0,0,0,0,0,0,
0,0,0,0,0,0,0,0,0,0,0,0,0,0,0,0,0,0,0,0,0,0,0,0,0,0,0,0,0,0,0,0,0,0,0,0,0,0,0,0,0,0,0,0,0,0,0,0,0,0,
0,0,0,0,0,0,0,0,0,0,0,0,0,0,0,0,0,0,0,0,0,0,0,0,0,0,0,0,0,0,0,0,0,0,0,0,0,0,0,0,0,0,0,0,0,0,0,0,0,0,
0,0,0,0,0,0,0,0,0,0,0,0,0,0,0,0,0,0,0,0,0,0,0,0,0,0,0,0,0,0,0,0,0,0,0,0,0,0,0,0,0,0,0,0,0,0,0,0,0,0,
0,0,0,0,0,0,0,0,0,0,0,0,0,0,0,0,0,0,0,0,0,0,0,0,0,0,0,0,0,0,0,0,0,0,0,0,0,0,0,0,0,0,0,0,0,0,0,0,0,0,
0,0,0,0,0,0,0,0,0,0,0,0,0,0,0,0,0,0,0,0,0,0,0,0,0,0,0,0,0,0,0,0,0,0,0,0,0,0,0,0,0,0,0,0,0,0,0,0,0,0,
0,0,0,0,0,0,0,0,0,0,0,0,0,0,0,0,0,0,0,0,0,0,0,0,0,0,0,0,0,0,0,0,0,0,0,0,0,0,0,0,0,0,0,0,0,0,0,0,0,0,
0,0,0,0,0,0,0,0,0,0,0,0,0,0,0,0,0,0,0,0,0,0,0,0,0,0,0,0,0,0,0,0,0,0,0,0,0,0,0,0,0,0,0,0,0,0,0,0,0,0,
0,0,0,0,0,0,0,0,0,0,0,0,0,0,0,0,0,0,0,0,0,0,0,0,0,0,0,0,0,0,0,0,0,0,0,0,0,0,0,0,0,0,0,0,0,0,0,0,0,0,
0,0,0,0,0,0,0,0,0,0,0,0,0,0,0,0,0,0,0,0,0,0,0,0,0,0,0,0,0,0,0,0,0,0,0,0,0,0,0,0,0,0,0,0,0,0,0,0,0,0,
0,0,0,0,0,0,0,0,0,0,0,0,0,0,0,0,0,0,0,0,0,0,0,0,0,0,0,0,0,0,0,0,0,0,0,0,0,0,0,0,0,0,0,0,0,0,0,0,0,0,
0,0,0,0,0,0,0,0,0,0,0,0,0,0,0,0,0,0,0,0,0,0,0,0,0,0,0,0,0,0,0,0,0,0,0,0,0,0,0,0,0,0,0,0,0,0,0,0,0,0,
0,0,0,0,0,0,0,0,0,0,0,0,0,0,0,0,0,0,0,0,0,0,0,0,0,0,0,0,0,0,0,0,0,0,0,0,0,0,0,0,0,0,0,0,0,0,0,0,0,0,
0,0,0,0,0,0,0,0,0,0,0,0,0,0,0,0,0,0,0,0,0,0,0,0,0,0,0,0,0,0,0,0,0,0,0,0,0,0,0,0,0,0,0,0,0,0,0,0,0,0,
0,0,0,0,0,0,0,0,0,0,0,0,0,0,0,0,0,0,0,0,0,0,0,0,0,0,0,0,0,0,0,0,0,0,0,0,0,0,0,0,0,0,0,0,0,0,0,0,0,0,
0,0,0,0,0,0,0,0,0,0,0,0,0,0,0,0,0,0,0,0,0,0,0,0,0,0,0,0,0,0,0,0,0,0,0,0,0,0,0,0,0,0,0,0,0,0,0,0,0,0,
0,0,0,0,0,0,0,0,0,0,0,0,0,0,0,0,0,0,0,0,0,0,0,0,0,0,0,0,0,0,0,0,0,0,0,0,0,0,0,0,0,0,0,0,0,0,0,0,0,0